11111111111111
10E00000000001
10C00C00C00C01
10000000080001
10P00000000001
11111111111111
