111111111
1C000C001
101111101
101C00101
10101E1C1
101011101
1P10C0001
111111111
